filename, language, Java, Properties, Markdown, comment, blank, total
c:\Users\Elliot\Desktop\Zombie\.gitattributes, Properties, 0, 1, 0, 1, 1, 3
c:\Users\Elliot\Desktop\Zombie\Camera.java, Java, 12, 0, 0, 0, 4, 16
c:\Users\Elliot\Desktop\Zombie\Entity.java, Java, 6, 0, 0, 0, 0, 6
c:\Users\Elliot\Desktop\Zombie\Game.java, Java, 61, 0, 0, 10, 14, 85
c:\Users\Elliot\Desktop\Zombie\GameView.java, Java, 102, 0, 0, 4, 20, 126
c:\Users\Elliot\Desktop\Zombie\GroundTile.java, Java, 16, 0, 0, 0, 0, 16
c:\Users\Elliot\Desktop\Zombie\KeyChecker.java, Java, 41, 0, 0, 5, 14, 60
c:\Users\Elliot\Desktop\Zombie\Main.java, Java, 6, 0, 0, 0, 1, 7
c:\Users\Elliot\Desktop\Zombie\Player.java, Java, 43, 0, 0, 0, 5, 48
c:\Users\Elliot\Desktop\Zombie\README.md, Markdown, 0, 0, 1, 0, 1, 2
c:\Users\Elliot\Desktop\Zombie\ViewLoop.java, Java, 22, 0, 0, 0, 3, 25
Total, -, 309, 1, 1, 20, 63, 394