filename, language, Java, Properties, Markdown, comment, blank, total
c:\Users\Elliot\Desktop\ZombieSpel\.gitattributes, Properties, 0, 1, 0, 1, 1, 3
c:\Users\Elliot\Desktop\ZombieSpel\Camera.java, Java, 12, 0, 0, 0, 4, 16
c:\Users\Elliot\Desktop\ZombieSpel\Entity.java, Java, 16, 0, 0, 0, 1, 17
c:\Users\Elliot\Desktop\ZombieSpel\Game.java, Java, 196, 0, 0, 8, 32, 236
c:\Users\Elliot\Desktop\ZombieSpel\GameView.java, Java, 140, 0, 0, 18, 20, 178
c:\Users\Elliot\Desktop\ZombieSpel\GroundTile.java, Java, 18, 0, 0, 0, 0, 18
c:\Users\Elliot\Desktop\ZombieSpel\KeyChecker.java, Java, 41, 0, 0, 5, 14, 60
c:\Users\Elliot\Desktop\ZombieSpel\Main.java, Java, 6, 0, 0, 3, 3, 12
c:\Users\Elliot\Desktop\ZombieSpel\Player.java, Java, 55, 0, 0, 1, 3, 59
c:\Users\Elliot\Desktop\ZombieSpel\README.md, Markdown, 0, 0, 7, 0, 1, 8
Total, -, 484, 1, 7, 36, 79, 607